{
	"name": "Baño",
	"position": [0,2],
    "sublevels": [],
	"map": [-1, -1, -1, -1, -1, -1,  0,  0, -1, -1,
			 0,  0,  0,  0,  0,  0,  0,  0, -1, -1,
			 1,  0,  0,  0,  0,  0,  0,  0, -1, -1,
			 0,  0,  0,  0,  0,  0,  0,  0, -1, -1,
			 0,  0,  0,  0,  0,  0,  0,  0, -1, -1,
			 0,  0,  0,  0,  0,  0,  0, -1, -1, -1,
			-1,  0,  0,  0,  0,  0,  0, -1, -1, -1,
			 0,  0,  0,  0,  0,  0,  0,  0,  0,  0,
            -1,  0,  0,  0,  0,  0,  0,  0,  0,  0,
			 0,  0,  0,  0,  0,  0,  0,  2,  0,  0],
    "sentences": {
    },
    "items": [
        {"name": "soap", "position": [6, 1]}
    ],
    "itemObject": [
        {"name": "sink"}
    ]

}