{
	"name": "Cocina",
	"position": [0,2],
    "sublevels": [3],
	"map": [-1, -1, -1, -1, -1, -1, -1, -1, -1,  -1,
			-1, -1, -1, -1, -1, -1, -1, -1, -1,  -1,
			 1,  0,  0,  0,  0,  0,  0,  0,  0,  2,
			 0,  0,  0,  0,  0,  0,  0,  0,  0,  0,
			 0,  0,  0, -1, -1, -1, -1,  0,  0,  0,
			 0,  0,  0, -1, -1, -1, -1,  0,  0,  0,
			 0,  0,  0,  0,  0,  0,  0,  0,  0,  0,
			 3,  0,  0,  0,  0,  0,  0,  0,  0,  0,
			-1, -1, -1, -1, -1, -1, -1, -1, -1,  -1,
			-1, -1, -1, -1, -1, -1, -1, -1, -1,  -1],
    "sentences": {
    },
    "items": [
        {"name": "sensor", "position": [2, 2]},
        {"name": "encoder", "position": [3, 3]}
    ],
    "itemObject": [
        {"name": "fridge"}
    ]
}