{
	"name": "Cocina",
	"position": [0,2],
    "sublevels": [3],
	"map": [-1, -1, -1, -1, -1, -1, -1, -1, -1,  -1,
			-1, -1, -1, -1, -1, -1, -1, -1, -1,  -1,
			 1,  0,  0,  0,  0,  0,  0,  0,  0,  2,
			 0,  0,  0,  0,  0,  0,  0,  0,  0,  0,
			 0,  0,  0, -1, -1, -1, -1,  0,  0,  0,
			 0,  0,  0, -1, -1, -1, -1,  0,  0,  0,
			 0,  0,  0,  0,  0,  0,  0,  0,  0,  0,
			 0,  0,  0,  0,  0,  0,  0,  0,  0,  0,
			-1, -1, -1, -1, -1, -1, -1, -1, -1,  -1,
			-1, -1, -1, -1, -1, -1, -1, -1, -1,  -1]
}